....................................
..S...#......................#......
......#......................#......
.............................#......
....................................
....................................
..............#.....................
............#.......................
..........#.........................
....................................
.....................############...
.....................#....X.....#...
.....................############...
....................................