....................................
..S...#......................#......
......#......................#......
..............#..............#......
..............#.....................
..............#.....................
..............#.....................
............##......................
..........##........................
...........#........................
.....................##########.#...
.....................#....X.....#...
.....................#..........#...
....................................
